Shiji	史記 
Hanshu	漢書 
Sanguozhi	三國志 
HouHanShu	後漢書 
Songshu	宋書 
Nanqishu	南齊書 
Weishu	魏書 
LiangShu	梁書 
Chenshu	陳書 
BeiQishu	北齊書 
Zhoushu	周書 
SuiShu	隋書 
Jinshu	晉書 
Nanshi	南史 
Beishi	北史 
JiuTangshu	舊唐書 
XinTangshu	新唐書 
JiuWudaishi	舊五代史 
XinWudaishi	新五代史 
Songshi	宋史 
Yuanshi	元史
